################
A #     #      #
# # ### # #### #
# # #   # #    #
# # # ### # # ##
# # # #   # #  #
# # # # ### #  #
#   #   #   #  B
################