#########
A #     #
# # # # #
# # # # #
#   #   B
#########