##########
A  #     #
#  #  ## #
#  #  #  #
#  ## #  #
#  #  #  #
#  ## #  #
#     #  B
##########